31 31
1011111111111111111111111111111
1000000000000000001000000000101
1010111011111111111011101110101
1010001000000010101010100010001
1010111011101110101010111111101
1010001000100000001000001000101
1011111010111011111010111011111
1000100010001000000010000000001
1010111011111110101011111010111
1010100000000010101000001010001
1011111011111011111111111111111
1000001000001000100010000000001
1010101010111110101110111111111
1010101010000010000000000000001
1011111011101110111010111111111
1000001000100010001010000000101
1010111010101110111110101010101
1010100010100010000010101010001
1010101010111011111110101111111
1010101010001000000010100000001
1110101110111111111011111110101
1000100010000010001000000010101
1011101111101010101110101111101
1010001000001000100010101000101
1011111010101011111011101010101
1000001010101000001000100010101
1010101111101010111111101111111
1010100000101010000000101000001
1011101110101010111011111011111
1000101000101010001000000000001
1111111111111111111111111111101
